0000000000
0000300000
0111211110
0111111110
0110300110
0110000110
0110000110
0110000110
0111111110
0111111110
0000000000
