00000000000000
00000000000000
00111111111100
00111111111100
00111111111100
00111111111100
0011EE11111100
00EEMM21111103
00111111111100
001111M1111100
00111111111100
00111111111100
00000000000000
00000000000000
