0000000000
0011211100
0010000100
0010000100
0010000100
0010000100
0010000100
0010000100
0011111100
0000000000
