0000000003000000000
0001111112111111110
00M1000003000000010
0110011100001110010
0100010101111010010
0100010101000010010
0100110101111010010
0101E1010000101E010
0M11100111111011110
0E00000000000000000
