0000000000000000000
0001111112111111110
0011000000000000010
0110011100001110010
0100010101111010010
0100010101000010010
0100110101111010010
0101110100001011010
0111100111111011110
0000000000000000000