0000000000
0011211100
0010000100
0010000100
0010000100
0010000100
0010000100
0010000100
0011111100
00000000000000
0
0
0